1111D11111
1000000001
1020111101
1000000001
1000300001
1111111111