1111111111
1010001001
1111D11111
1000000001
11110S0A01
10G0000G01
1111D11111
1000000001
10G0111101
100000A001
1010E00001
1111111111
