1111111111
1010001001
1111D11111
1000000001
1111000001
10G0000E01
1111D11111
1000000001
10G0111101
1000000001
1010E00001
1111111111
