111111111111111111111111
101000100111111111111111
1111D1111111111111111111
100000000111111111111111
11110S0A0111111111111111
10G000HG0111111111111111
1111D1111111111111111111
100000000100001000000001
10G01110010G001000B00001
1000H0A00D0A00100A0E0001
1010E000010000S000000001
111111111111111111111111
